{
	"Cells":[
	        "##############################",
			"#............................#",
			"#............................#",
			"#..########################..#",
			"#..#....#..........#......#..#",
			"#..#....#..........#......#..#",
			"#..######..........#......#..#",
			"#..#....############......#..#",
			"#..#....#......#...#......#..#",
			"#..#....#......#...#......#..#",
			"#..########################..#",
			"#..#........#......#......#..#",
			"#..#........#......#......#..#",
			"#..#........###############..#",
			"#..#........#.............#..#",
			"#..#........#.............#..#",
			"#..########################..#",
			"#............................#",
			"#............................#",
			"##############################"
			],
	"RoomsData":[
	            [4, 4, 4, 2],
			    [9, 4, 10, 3],
			    [20, 4, 6, 6]
                ],
	"RoomsPlan":[
	                [
	                    [
					    "t...",
					    "h.bb"
				        ],
					    [
					    "b.th",
					    "b..."
					    ],
					    [
					    "th..",
					    "bb.."
					    ]
					],
				    [
					    [
					    ".k......k.",
						"..........",
						".k......k."
					    ],
					    [
					    "..h.h.h...",
					    ".htttttth.",
						"...h.h.h.."
					    ]
				    ],
					[
					    [
						"======",
						"......",
						"....ht",
						"......",
						"......",
						"....bb"
						]
					]
			    ]
}