{
	"Cells":[
	        "##############################",
			"#;;;;;;;;;;;;;;;;;;;;;;;;;;;;#",
			"#;;;;;;;;;;;;;;;;;;;;;;;;;;;;#",
			"#;;;################----->;;;#",
			"#;;;#.....+.+......#,,,,,|;;;#",
			"#;;;#.....#.#......#,,,,,|;;;#",
			"#;;;#######.########,,,,,|;;;#",
			"#;;;#.....+.+......#,,,,,|;;;#",
			"#;;;#.....#.#......#,,,,,|;;;#",
			"#;;;#######.########,,,,,|;;;#",
			"#;;;#.....+.+......#,,,,,:::;#",
			"#;;;#.....#.#......#,,,,,:::;#",
			"#;;;#######.##########++##;;;#",
			"#;;;#.....+........+.....#;;;#",
			"#;;;#.....#.h.h.h.w#.====#;;;#",
			"#;;;#.....#.ttttt.w#...h.#;;;#",
			"#;;;######################;;;#",
			"#;;;;;;;;;;;;;;;;;;;;;;;;;;;;#",
			"#;;;;;;;;;;;;;;;;;;;;;;;;;;;;#",
			"##############################"
			],
	"RoomsData":[
	                [5, 4, 5, 2],
			        [5, 7, 5, 2],
			        [5, 10, 5, 2],
			        [5, 13, 5, 3],
			        [13, 4, 5, 2],
			        [13, 7, 5, 2],
			        [13, 10, 5, 2]
                ]
}